1111111111111111111111111111111
1E00100000C0000100000C0000000C1
1000001011100CC0011001110000CC1
111100C00100001100101C000011001
1CC1011000C000C001001C010011001
1C11011110011000011001110C00P01
100000010011001000C010000011001
1111111111111111111111111111111