1111111111111111111
1CS00000000000100P1
1111CS000E000000101
1CS0000000S00000001
1111111111111111111