111111111111111111111111111111111
1S00000000000000P100001000000CCC1
101111110011111111111000111010111
100000000000000100000001000000001
111111111111101011101110101010101
1000000100CC100000100010101010001
101011111011111010110C11101011011
101000000000010001000100010000001
101111111111100101011101001111111
101000000001010100000001010000001
101111101000100110101011111011101
1CC01000101000100010101000010CC01
111010111011101011101010111110101
101010001000101000101000CCCC10101
101011101110111110111111111110101
1CCC000010000000000000000000001E1
111111111111111111111111111111111