1111111111111111111
1C000000000000100P1
1111C0000E000000101
1C00000000000000001
1111111111111111111